1111111111111111111111111
1000000000000000P00000EC1
100000C000000000000000011
1111111111111111111111111
