1111111111111
1001010000001
11001P0010C11
100001E000001
1111111111111
