







111111111111
100PEC000001
111111111111
