111111111111
100PECT00T11
111111111111
