11111
11C11
10E01
11101
11P11
11111
