1111111111111
10010000PC011
1000001000001
100C01E010011
1000001000001
1000C00C00011
1111111111111
