111111111111111111111111111111111111111111111111111111111
10010000PC01111111111111111111111111111111111111111111111
100000100000111111111111111111111111111111111111111111111
100C01E01001111111111111111111111111111111111111111111111
1000001000000000C0110100111111111111111111111111111111111
1000C00C00011100C0000100111111111111111111111111111111111
111111111111111111111111111111111111111111111111111111111
