1111111111111
10010000000C1
1000011110011
1P0011E000010
1111111111111
