111111111111111111111111111111
1C0000000000000000000000000001
1000000000P0000000000000000001
100000000000000000000000000001
100000100000000TC0000000000001
100000000000000000000000000001
100000C0T000000000000000000001
1000000000000000000000C0000001
111111111111110111111111111111
100000000000000000000000000001
100000000010000000000000000001
1000000000000000000000000T0001
100TCT000000000000000000TET001
1000T0000000000000000000000001
100000000000000000000000000001
111111111111111111111111111111
