11111111111111111111111111111
1111111C0C000E1111P0C0CC00001
111111C0C00C0001111C000000001
11111C0C011C0C011111111110001
1111C0C0111C0C011111111110001
111C0C01111C0C011111111110001
11C0C011111C0C011111111110001
1C0C0111111C0C011111111110001
1C0C00C00C00C00C011111C000001
1111111111C0C0011111C0C001111
11111111111C0001111C0C0011111
11111111111C0C01111C0C0011111
11111111111C0C01111C0C0011111
1111111111C000CC0000CC0000001
111111111C0C00000CC0000C00C01
11111111111111111111111111111
