111111111111111111111111111111
1E00000T0000000C0000TC00T00001
101001010010000010100100000001
1010010010101010001001000T0001
1P000000C00C000000000000000001
111111111111111111111111111111
