11111111111111111111111111111111111111
1111111C0C000E1111P0C0CC00000000001111
111111C0C00C0001111C00000111111C0C0011
11111C0C011C0C01111111111111111C0C0011
1111C0C0111C0C01111111111111111C0C0011
111C0C01111C0C01111111111111111C0C0011
11C0C011111C0C01111111111111111C0C0111
1C0C0111111C0C011111111111100000000001
1C0C00C00C00C00C011111C00000C011111111
1111111111C0C0011111C0C001111111111111
11111111111C0001111C0C0011111111111111
11111111111C0C01111C0C0011111111111111
11111111111C0C01111C0C0011111111111111
1111111111C000CC0000CC0001111111C0CCC1
111111111C0C00000CC0000C00C00C00C00C01
11111111111111111111111111111111111111
